//level reader doc

S = start I think, not sure, could be start of enemies as well
B = money bag
H = horizontal tunnel
V = Vertical tunnel
C = emerald
 = nothing
and well one string is one line of the level
LEVEL 1:
{"    B     HHHHS", 
  "V  CC  C  V B  ", 
  "VB CC  C  V    ", 
  "V  CCB CB V CCC", 
  "V  CC  C  V CCC", 
  "HH CC  C  V CCC", 
  " V    B B V    ", 
  " HHHH     V    ", 
  "C   V     V   C", 
  "CC  HHHHHHH  CC"} 
  
  
  LEVEL 2:
 {"HHHHHH  B B  HS",
  " CC  V       V ",
  " CC  V CCCCC V ",
  "BCCB V CCCCC V ",
  "CCCC V       V ",
  "CCCC V B  HHHH ",
  " CC  V CC V    ",
  " BB  VCCCCV CC ",
  "C    V CC V CC ",
  "CC   HHHHHH    "}
  
  LEVEL 3:
 {"HHHHHB B BHHHHS",
  "CC  V C C V BB ",
  "C   V C C V CC ",
  " BB V C C VCCCC",
  "CCCCV C C VCCCC",
  "CCCCHHHHHHH CC ",
  " CC  C V C  CC ",
  " CC  C V C     ",
  "C    C V C    C",
  "CC   C H C   CC"}
  
  LEVEL 4:
 {"HHBCCCCBCCCCBHS",
  "CV  CCCCCCC  VC",
  "CHHH CCCCC HHHC",
  "C  V  CCC  V  C",
  "   HHH C HHH   ",
  "  B  V B V  B  ",
  "  C  VCCCV  C  ",
  " CCC HHHHH CCC ",
  "CCCCC CVC CCCCC",
  "CCCCC CHC CCCCC"}
  
  LEVEL 5:
 {"HHHHHHHHHHHHHHS",
  "VBCCCCBVCCCCCCV",
  "VCCCCCCV CCBC V",
  "V CCCC VCCBCCCV",
  "VCCCCCCV CCCC V",
  "V CCCC VBCCCCCV",
  "VCCBCCCV CCCC V",
  "V CCBC VCCCCCCV",
  "VCCCCCCVCCCCCCV",
  "HHHHHHHHHHHHHHH"}
  
  LEVEL 6:
 {"HHHHHHHHHHHHHHS",
  "VCBCCV V VCCBCV",
  "VCCC VBVBV CCCV",
  "VCCCHH V HHCCCV",
  "VCC V CVC V CCV",
  "VCCHH CVC HHCCV",
  "VC V CCVCC V CV",
  "VCHHBCCVCCBHHCV",
  "VCVCCCCVCCCCVCV",
  "HHHHHHHHHHHHHHH"}
  
  LEVEL 7:
 {"HHCCCCCVCCCCCHS",
  " VCBCBCVCBCBCV ",
  "BVCCCCCVCCCCCVB",
  "CHHCCCCVCCCCHHC",
  "CCV CCCVCCC VCC",
  "CCHHHCCVCCHHHCC",
  "CCCCV CVC VCCCC",
  "CCCCHH V HHCCCC",
  "CCCCCV V VCCCCC",
  "CCCCCHHHHHCCCCC"}
  
  LEVEL 8:
 {"HHHHHHHHHHHHHHS",
  "V CCBCCCCCBCC V",
  "HHHCCCCBCCCCHHH",
  "VBV CCCCCCC VBV",
  "VCHHHCCCCCHHHCV",
  "VCCBV CCC VBCCV",
  "VCCCHHHCHHHCCCV",
  "VCCCC V V CCCCV",
  "VCCCCCV VCCCCCV",
  "HHHHHHHHHHHHHHH"}
  
  